#################################################
#################################################
#                                               #
#                                               #
#                                               #
#                                               #
#                                               #
#                                               #
#                                               #
#                                               #
#                                               #
#                                               #
#                                               #
#                                               #
#                                               #
#                                               #
##################                              #
#                                               #
#                                               #
#                                               #
#                                               #
#                                               #
#                              ##################
#                                               #
#                                               
#################################################
#################################################
