#################################################
#################################################
#                #                              #
#                #                              #
#                #                              #
#                #                              #
#                #                              #
#                #                              #
#                #                              #
#                #                              #
#                #                              #
#                #                              #
#                #                              #
#                                               #
#                                               #
#                                               #
##################                              #
##################             ggggggggggggggggg#
##################             ggggggggggggggggg#
##################             ggggggggggggggggg#
##################             ggggggggggggggggg#
##################             ggggggggggggggggg#
##################             ggggggggggggggggg#
##################                              
##################                              
#################################################
#################################################
