###############################
#     # #       #   #   # #   #
#@### # # # # # ### ### # ### #
#   # # # # # #     #   #     #
##### # # ####### # # ### ### #
#       # #       #       #   #
### # # ### ####### ### #######
# # # # #   #   # #   #       #
# ##### # ### ### ##### ### # #
#     # # #   #     #     # # #
# ##### # # # # ### # ####### #
# #     # # # #   #     # # # #
# # ######### # # # ##### # # #
#   #   #     # # #   #   #   #
# ### ### ### # ##### # ##### #
# #   #   #     # # # #     # #
# # # ######### # # ##### # # #
# # #               # #   #   #
# # ### ### ### # ### # ### ###