###############################
#       #   #         #       #
#@##### # # # ####### # # # # #
#     # # #   # # #   # # # # #
# ######### ### # ### # ### ###
# #   #   # #   # #   #   #   #
# # # ### # ### # # ####### # #
#   #         #   #   # #   # #
# ### ##### ### # ### # # ### #
#   # #   #     # # #     # # #
######### ### # ### # # ### # #
# #       # # #       #   #   #
# ### # # # # ### ### ####### #
# # # # #       # #   #       #
# # ### ### ### ### #   ### # #
#       #   #     # # # #   # 
############################# 